----------------------------------------------------------------
#---------------------------------------------------------------
##--------------------------------------------------------------
####-----------------------------------------------------------#
#########----------------------------------------------------###
#####4#####------------------------------------------------#####
#############--------------------------------------------#######
################-------------------------------------###########
###################--------------------------------#############
#####################--------------------------#################
#######################-----------------------##################
########################---------------------#--################
#########################------@----------#----#####----########
#########################^^^^^^^--^^^^^^^^#####--------#########
###############################--#############------############
################################--##############################
#################################-##############################
##################################--############################
#################################--#############################
###################################--###########################
##################################--############################
##################################-#############################
##################################--############################
###################################-############################
#################################--#############################
################################--##############################
################################-###############################
################################--##############################
#################################-##############################
###########################4444--4444###########################
###########################222--22222###########################
